1111111111111
1P110000000C1
1110011111001
100011E000001
1111111111111