11111111111111111111111111111111111111111111111111111111111111111
1C010000000000010000000000000000000001C100000000000000010000000C1
10000111111110010000000000000010000001010000000000000001011111111
11111100000000011100000000000010000001010000000000000000000000001
10000000001111111111111100000010000001010000000C00000000000000001
10000000000000000C00000000000010000001010000000000000000000000001
10000000000000000000000000000010000001010000000000000000000000001
10000000000000000000000000000010000001011111111000000000000000001
10000000000000000000000000000010000000000000000000000000000000001
1000000001111111111111111111111C00000000000000000000000000CC00001
1000000001000000000000000000001111111111111100000000000000CC00001
1C00000001000000000000000000001C000000000000000000000000000000001
10000000010000000000000C00000010000000000010000000000000000000001
10000000010000000000000000000010000000000011111111111111111111101
10000000C1000000000000000000001000000000001C000000000000000000001
10011111111111111111000000000010000000000010000000000000000000001
10010000000000000001000000000010000000000010000000000000000000001
10010000000000000001000000000010000000000010000000000000000000001
10010000000000000001000000000010000000000010000000000000000000001
100100000000000011111111C0000010000000000010000000000000000000001
10011111111111101111111111111001000000000001000000000000000000001
10000000000000000000000000000010000000000010000000000000000000001
10000000000000000000000000000010000000000010000000000000000000001
10000000000000000000000000000010000000000010000000000000000000001
10000000000000000000000000000C1000000000001C000000000000000000001
10000000000000000011111111111111111111111111111111000000000111111
1000000000000000001C00000000000000000C10000000000000000C000000001
10000000000000000010000000000000000000100011111111111111111111111
100000000000000000100000000000000000001000000000000000000000000C1
10000000000000000C1C0000000000000000001000C0000000000000000000001
10000011111111111111100000000000000000100000000000000000000000001
10000100000000000000000000000000000000111111111111111111110000001
10001C0000000000000000000000000000000000000000C000000000000000001
100011E00000000000000000000000000000000000000000000000000000000P1
11111111111111111111111111111111111111111111111111111111111111111